24
11
11
08
    #####              
    #   #              
    #o  #              
  ###  o##             
  #  o o #             
### # ## #   ######    
#   # ## #####    #    
# o  o            #    
##### ### # ##    #    
    #     #########    
    #######            
6
16 06
17 06
16 07
17 07
16 08
17 08